0000000000000000000000000000
0100000011100000000000001100
0000000001100000000000000000
0000000000100000010000000000
0000000000000000011112000000
0000111000000000000100000000
0000010000000000222200000000
